......########......
....................
.....##########.....
....................
....############....
....................
..........@.........
....................
....#..........#....
....#..........#....
....#..........#....
....#..........#....
....................
....................
....................
....############....
....................
.....##########.....
....................
......########......