...............#####
...................#
...................#
...................#
...................#
...................#
...................#
...................#
....................
.........@..........
....................
....................
....................
#...................
#...................
#...................
#...................
#...................
#...................
######..............
