....................
....................
....................
......######........
......#.............
......#.............
......#...@.........
......#.............
......####..........
.........#..........
.........#..........
.........#..........
.........#####......
....................
....................
....................
...................#
...................#
...................#
...............#####